ばーちゃるしんがー	VIRTUAL SINGER	固有名詞
れおにーど	Leo/need	固有名詞
もあもあじゃんぷ	MORE MORE JUMP!	固有名詞
もあもあじゃんぷ	MORE MORE JUMP！	固有名詞
びびっどばっどすくあっど	Vivid BAD SQUAD	固有名詞
わんだーらんずしょうたいむ	ワンダーランズ×ショウタイム	固有名詞
にじゅうごじないとこーどで	25時、ナイトコードで。	固有名詞

ばちゃしん	VIRTUAL SINGER	短縮よみ
れおに	Leo/need	短縮よみ
レオニ	Leo/need	短縮よみ
もあじゃん	MORE MORE JUMP！	短縮よみ
もあじゃん	MORE MORE JUMP!	短縮よみ
ももじゃん	MORE MORE JUMP！	短縮よみ
ももじゃん	MORE MORE JUMP!	短縮よみ
びびばす	Vivid BAD SQUAD	短縮よみ
わんだしょ	ワンダーランズ×ショウタイム	短縮よみ
にーご	25時、ナイトコードで。	短縮よみ
にご	25時、ナイトコードで。	短縮よみ
ニーゴ	25時、ナイトコードで。	短縮よみ

あおはるふれんず	青春/friends	固有名詞
ゆめゆめじゃんぷ	YUME YUME JUMP!	固有名詞
ゆめゆめじゃんぷ	YUME YUME JUMP！	固有名詞
ふぁんたじすたすくあっど	Fantasista SQUAD	固有名詞
はぴねすせんたいさにさにわんだー	ハピネス戦隊サニサニ☆ワンダー	固有名詞
きゅうじつしゅみじんどうしで	休日、趣味人同士で。	固有名詞
